5 5
x x x x x
x o o g x
x o o o x
x p o o x
x x x x x