7 7
x x x x x x x
x g o o o o x
x o o o o o x
x o o o o o x
x o o o o o x
x o o o p o x
x x x x x x x