7 6
x x x x x x x
x p o x x x x
x o o x x x x
x o o o o o x
x x x x o g x
x x x x x x x
