10 10
x x x x x x x x x x
x o o o o o o o o x
x o g o x o x o o x
x o o o x o o o o x
x o x x x o x x x x
x o o o o o o o o x
x o o o x x x o o x
x o x o x x x o o x
x o o o x o x o p x
x x x x x x x x x x